No.,Name,Code,Section,Batch,Students,Male,Female
1,01,01,"",1,26,17,9
2,02,02,"",1,18,9,9
3,03,03,"",1,24,10,14
4,04,04,"",1,18,7,11
5,05,05,"",1,12,10,2
6,06,06,"",1,9,4,5
7,07,07,"",1,14,7,7
8,08,08,"",1,6,2,4
9,09,09,"",1,10,4,6
10,10,10,"",1,15,12,3
11,NU,NU,"",1,16,9,7
12,PG,PG,"",1,10,6,4
13,PR,PR,"",1,21,13,8
