No.,Name,Code,Section,Batch,Students,Male,Female
1,01,01,"",2,49,28,21
2,02,02,"",2,41,26,15
3,03,03,"",2,43,26,17
4,04,04,"",2,45,27,18
5,05,05,"",2,45,26,19
6,06,06,"",2,48,33,15
7,10,10,"",2,43,29,14
8,7th,07,"",2,44,30,14
9,8th,08,"",2,37,26,11
10,9th,09,"",2,43,36,7
11,KG,KG,"",2,48,27,21
12,NUR,NUR,"",2,41,26,15
13,PG,PG,"",1,28,22,6
